1111
1E01
1C01
1P01
10C1
1C01
10C1
1C01
10C1
1111