1111
1E01
1C01
1P01
1TC1
10C1
1TC1
10C1
1TC1
1111