1111111111111111111111111111111111
1T1T0001C0000000010C00100T010T0C01
1C00010111111001010T00111011000011
1011110100001T01C1C00C001110001001
10T0010100T0110001110110001C011T01
1C111100010000C0010C01T0001111C001
10100T010111111111000100100C100011
10111C0100000000010001011000101001
1010CC011111111101101101T0111010C1
1C101T000T0P0001001010010010001111
1011111100010T0100101011E010000001
10T0C0T111110101000010C11111110101
1C0010010CT1C101011111111C0000C001
11111001100101011100C0T000010010T1
100C0000C0000100000110001001001CC1
1111111111111111111111111111111111