111111111111111111111111111111
111111111111P000000000C1111111
110CTCTCTC00000000000001111111
110000000000001110000000000111
110011000000001110011111100111
11001111110000TC10000000100111
1100000001000000000011C0100111
111101100000100000C01111100111
111101100000101111100000000C11
11000000110010000C100000000T11
110000001111111111100000010011
110011100CTC000000001111010011
110011000000110011111111110011
110011000000110011000000000011
11C0000000000000000000E1111111
111111111111111111111111111111